1111111111111111111
1PCCCCCC1C1CCCCCCE1
1000000011100000001
1000000000000000001
1000011111111000001
1000000000000000001
1000000001000011101
1001000001000010001
1001000001000011101
1001000000000000001
1111111111111111111
